********************
*                  *
*                  *
*                  *
*                  *
*           **     *
*    *             *
*                  *
*              *****
*                  *
********************